~ same pronunciation
โยคะ ~ Yoga
สมาธิ ~ samadhi, saL maaM thiH, meditation; concentration; focus
ราชา ~ raa-chaa	king	Sanskrit	राजा/rājā
คชา ~ kha-chaa	elephant	Sanskrit	गज/gaja
ประเทศ ~ pra-thêet	country	Sanskrit	प्रदेश/pradesh
สันติ ~ sǎn-tì	peace	Sanskrit	शान्ति/śānti
ภูมิ ~ phuum	soil	Sanskrit	भूमि/bhūmi
วาจา ~ waa-jaa	words	Sanskrit	वाचा/vācā
ภาวะ ~ phaa-wá	condition	Sanskrit	भव/bhava
ภักดี ~ phák-dii	loyal	Sanskrit	भक्ति/bhakti
พายุ ~ phaa-yú	storm	Sanskrit	वायु/vayu
เวลา ~ wee-laa	time	Sanskrit	वेला/velā
อาสา ~ aa-sǎa	hope(desire)	Sanskrit	asha
จักรวาล ~ jàk-kra-waan	universe	Sanskrit	chakravala
สตรี ~ sa-trii	woman	Sanskrit	स्त्री/strī
กรุณา ~ ka-ru-naa	please,compassion	Sanskrit	करुण/karuṇa
พุทธิ ~ phút-thí	intelligence	Sanskrit	बुद्धि/buddhi
วิทยา ~ wít-tha-yaa	science	Sanskrit	विद्या/vidyā = "knowledge"
ภาษา ~ phaa-să	language	Sanskrit	भाषा/bhāṣā
ครู ~ khruu	teacher	Sanskrit	गुरु/guru
มหา ~ ma-hăa	great	Sanskrit	महा/mahā

~ first syllable is closed, drop the final syllable
พุทธ ~ Buddha, phootH, silent trailing consonant
จักร ~ chakra, jakL, a nexus of metaphysical or biophysical energy
สิงห์ ~ sĭng	lion	Sanskrit	सिंह/singha
กษัตริย์ ~ ka-sàt	king	Sanskrit	क्षत्रिय/kṣatriya
สัตว์ ~ sàt	animal	Sanskrit	सत्व/satva
ทุกข์ ~ thúk	suffering	Sanskrit	दुःख/duḥkha
จันทร์ ~ jan	moon	Sanskrit	चन्द्र/chandra
สัปดาห์ ~ sàp-daa	week	Sanskrit	सप्ताह/saptāha
มนุษย์ ~ ma-nút	human being	Sanskrit	मनुष्य/manuṣya


~ first syllable is open, drop the trailing "a" sound and close the first syllable
ธรรม ~ tamM jor tam maM, Dharma
กรรม ~ Karma
กาม ~ Kama, gaamM maH or gaamM, in yogic philosophy , desire, 
รูป ~ rûp	picture	Sanskrit	रूप/rūpa
คุณ ~ khun	you,useful	Sanskrit	ghuna
นาม ~ naam	name	Sanskrit	नाम/namaa
ชีวิต ~ chii-wít	life	Sanskrit	जीवित/jīvita
อาหาร ~ aa-hǎan	food	Sanskrit	आहार/āhāra
ชีวิต ~ chii-wít	life	Sanskrit	जीवित/jīvita
รส ~ rót	taste	Sanskrit	रस/rasa
สุข ~ sùk	happiness	Sanskrit	सुख/sukha
นคร ~ ná-khorn	city	Sanskrit	नगर/nagara
วิหาร ~ wí-hǎan	temple	Sanskrit	विहार/vihāra
ชัย ~ chai	victory	Sanskrit	जय/jaya
อากาศ ~ aa-kàat	air	Sanskrit	आकाश/ākāśa

~ trailing a reinstated when combined with additional words
ธรรม ~ tamM jor tam maM, Dharma
ธรรมจักร ~ tamM maM jakL, the wheel of the law
