http://www.thai-language.com/ref/consonant-reduplication
กกุท	gaL gootL thaH	
กกุธ	gaL gootL thaH	
กฎนิคหกรรม	gohtL nikH khaH haL gamM	
กฎอัยการศึก 	gohtL aiM yaH gaanM seukL	
กตัญญูกตเวทิตา	gaL dtanM yuukF gaL dtaL waehM thiH dtaaM	
กรม	grohmM maH	
กรมธรรม์ 	grohmM maH thanM	
กรรม	gamM maH	
กรรมกร 	gamM maH gaawnM	
กรรมการก 	gamM maH gaaM rohkH	
กริยาสภาวมาลา	griL yaaM saL phaaM waH maaM laaM	
กฤษฎาภินิหาร	gritL saL daaM phiH niH haanR	
กฤษฎี	gritL saL deeM	
กฤษฎีกา 	gritL saL deeM gaaM	
กฤษณะ	gritL saL naH	
กล	gohnM laH	
กลวิธี	gohnM laH wiH theeM	
กลศาสตร์	gohnM laH saatL	
กัลบก	ganM laH bohkL	
กัลปาวสาน	ganM laH bpaaM waH saanR	
กัลยา 	ganM laH yaaM	
กัลยาณมิตร	ganM laH yaaM naH mitH	
กัลยาณี	ganM laH yaaM neeM	
กาม	gaamM maH	
กามกิจ	gaamM maH gitL	
กามตัณหา	gaamM maH dtanM haaR	
กามโลก	gaamM maH lo:hkF	
กาย	gaaiM yaH	
กาลปาวสาน	gaanM laH bpaaoM waH saanR	
กาฬโรค	gaanM laH ro:hkF	
กิจ	gitL jaL	
กิจการ 	gitL jaL gaanM	
กินรี 	ginM naH reeM	
กีฏวิทยา	geetL dtaL witH thaH yaaM	
กุล	goonM laH	
กุลพันธ์	goonM laH phanM	
กุศโลบาย	gootL saL lo:hM baaiM	
เกษมณี	gaL saehmM maH neeM	
คชสีห์	khohtH chaH seeR	
คณาธิปไตย	khaH naaM thipH bpaL dtaiM	
คณิต	khaH nitH dtaL	
คณิตวิเคราะห์	khaH nitH dtaL wiH khrawH	
คริสเตียน 	khritH saL dtiianM	
คหกรรมศาสตร์	khaH haL gamM maH saatL	
คัคนานต์ 	khakH khaH naanM	
คามวาสี	khaamM maH waaM seeR	
คุณ	khoonM naH	
คุณวุฒิ	khoonM naH wootH	
ฆาตกร	khaatF dtaL gaawnM	
โฆษณา 	kho:htF saL naaM	
จตุรพิธพร	jaL dtooL raH phitH thaH phaawnM	
จตุสดมภ์	jaL dtootL saL dohmM	
จักจี้	jakL gaL jeeF	
จั๊กจี้ 	jakH gaL jeeF	
จัตวา 	jatL dtaL waaM	
จันทรุปราคา	janM thaH roopH bpaL raaM khaaM	
จิตรมาส	jitL dtaL raH maatF	
จิตวิสัย	jitL dtaL wiH saiR	
จุล 	joonM laH	
จุลทรรศน์	joonM laH thatH	
จุลภาค	joonM laH phaakF	
เจตนา 	jaehtL dtaL naaM	
เจตนารมณ์ 	jaehtL dtaL naaM rohmM	
เจรจา 	jaehnM raH jaaM	
เจษฎาธิการ	jaehtL saL daaM thiH gaanM	
โจราธิปไตย	jo:hM raaM thipH bpaL dtaiM	
ชนนี 	chohnM naH neeM	
ชนบท 	chohnM naH bohtL	
ชราภาวาธิปไตย	chaH raaM phaaM waaM thipH bpaL dtaiM	
ชล	chohnM laH	
ชลประทาน	chohnM laH bpraL thaanM	
ชักเย่อ 	chakH gaL yuuhrF	
ชัชวาล	chatH chaH waanM	
ชันโรง	chanM naH ro:hngM	
ชันสูตร 	chanM naH suutL	
ชัยพร	chaiM yaH phaawnM	
ชัยภูมิ 	chaiM yaH phuumM	
ชานชลา	chaanM chaH laaM	
ชินวัตร 	chinM naH watH	
ชีพ	cheepF phaH	
ชุลมุน 	choonM laH moonM	
ซอมซ่อ	saawmM maH saawF	
ญาณทัสนะ	yaanM thatH saL naH	
ฐิตวรรณ	thitL dtaL wanM	
ดรรชนี 	datL chaH neeM	
ดัชนี 	datL chaH neeM	
ดาษดา	daatL saL daaM	
ดุริยางคศิลป์	dooL riH yaangM khaH sinR	
ดุลพินิจ	doonM laH phiH nitH	
ดุลยพินิจ	doonM laH yaH phiH nitH	
ดุษฎี 	dootL saL deeM	
ดุษฎีนิพนธ์	dootL saL deeM niH phohnM	
ดุษณี 	dootL saL neeM	
ตรรก	dtakL gaL	
ตรัส	dtratL saL	
ตฤณมัย 	dtrinM naH maiM	
ตั๊กแตน 	dtakH gaL dtaaenM	
ติณชาติ 	dtinM naH chaatF	
ตุ๊กตา 	dtookH gaL dtaaM	
ทรรศน์	thatH saL	
ทรรศนะ	thatH saL naH	
ทรัพยากร 	sapH phaH yaaM gaawnM	
ทฤษฎี 	thritH saL deeM	
ทศ	thohtH saL	
ทศทิศ	thohtH saL thitH	
ทศพิธราชธรรม	thohtH saL phitH raatF chaH thamM	
ทศวรรษ 	thohtH saL watH	
ทันตแพทยสภา	thanM dtaL phaaetF thaH yaH saL phaaM	
ทัศน 	thatH saL naH	
ทัศนคติ 	thatH saL naH khaH dtiL	
ทัศนอุจาด	thatH saL naH ooL jaatL	
ทัศนะ 	thatH saL naH	
ทัศนาจร 	thatH saL naaM jaawnM	
ทัศนีย์	thatH saL neeM	
ทัศนียภาพ	thatH saL neeM yaH phaapF	
ทานมัย	thaanM naH maiM	
ทารุณกรรม	thaaM roonM naH gamM	
ทิน	thinM naH	
ทุกรกิริยา	thookH gaL raH giL riH yaaM	
ทุคตะ	thookH khaH dtaL	
ทุคติ 	thookH khaH dtiL	
ทุทรรศนนิยม	thooH thatH saL naH niH yohmM	
ทุน	thoonM naH	
ทุพพลภาพ	thoopH phohnM laH phaapF	
เทพ	thaehpF phaH	
เทพย 	thaehpF phaH yaH	
เทศ	thaehtF saL	
เทศกาล 	thaehtF saL gaanM	
เทศกิจ	thaehtF saL gitL	
เทศนา 	thaehtF saL naaM	
เทศบาล 	thaehtF saL baanM	
โทมนัส 	tho:hmM maH natH	
โทษ	tho:htF saL	
ธนาธิปไตย	thaH naaM thipH bpaL dtaiM	
ธรรม	thamM maH	
ธรรมการย์	thamM maH gaanM	
ธรรมดา 	thamM maH daaM	
ธรรมนูญ 	thamM maH nuunM	
ธรรมภิบาล	thamM maH phiH baanM	
ธรรมยุติกนิกาย	thamM maH yooH dtiL gaL niH gaaiM	
ธรรมาธิษฐาน	thamM maaM thitH saL thaanR	
ธัญ	thanM yaH	
ธัญชาติ	thanM yaH chaatF	
ธัญบุรี 	thanM yaH booL reeM	
ธิปไตย	thipH bpaL dtaiM	
นพ	nohpH phaH	
นพคุณ 	nohpH phaH khoonM	
นพมาศ 	nohpH phaH maatF	
นางนพมาศ[prop.n, pers] Noppamas, granddaughter of พ่อขุนรามคำแหงมหาราช, a court lady of exceptional wit and charm; she was believed to be the first to have devised the กระทง  and to have raised court practices to a high standard
นมัสการ 	naH matH saL gaanM	
นรีเวชกรรม	naH reeM waehtF chaH gamM	
นรีเวชวิทยา	naH reeM waehtF wiH thaH yaaM	
นรีเวชศาสตร์	naH reeM waehtF chaH saatL	
นเรศวร	naH raehM suaanR	
นวัตกรรม	naH watH dtaL gamM	
นัยน 	naiM yaH naH	
นัยนา 	naiM yaH naaM	
นานัปการ	naaM napH bpaL gaanM	
นามธรรม 	naamM maH thamM	
นาวิก	naaM wikH gaL	
น่าอัปยศ	naaF apL bpaL yohtH	
นิคหิต 	nikH khaH hitL	
นิตยสาร 	nitH dtaL yaH saanR	
นิตยา	nitH dtaL yaaM	
นิทรรศการ 	niH thatH saL gaanM	
เนติบริกร	naehM dtiL baL riH gaawnM	
เนติบัณฑิตยสภา	naehM dtiL banM thitH dtaL yaH saL phaaM	
บรม	baawM rohmM maH	
บรรลัย	banM laiM yaH	
บัพชา	bapL phaH chaaM	
บัพชิต	bapL phaH chitH	
บาท	baatL thaH	
บุคคลิกภาพ	bookL khaH likH gaL phaapF	
บุคลากร 	bookL khaH laaM gaawnM	
บุคลาธิษฐาน 	bookL khaH laaM thitH thaanR	
บุคลิก 	bookL khaH likH	
บุคลิก	bookL khaH likH gaL	
บุณมี 	boonM naH meeM	
บุพการี 	boopL phaH gaaM reeM	
บุพบท 	boopL phaH bohtL	
คำบุพบท[n] [grammar] preposition
บุษบก 	bootL saL bohkL	
บุษบง 	bootL saL bohngM	
บุษบัน	bootL saL banM	
บุษบา 	bootL saL baaM	
บุษราคัม 	bootL saL raaM khamM	
โบราณ	bo:hM raanM naH	
ปกติ	bpohkL gaL dtiL	
ปฏิปทา	bpaL dtipL bpaL thaaM	
ปฐพี	bpohtL thaL pheeM	
ปฐมภูมิ	bpaL thohmR maH phuumM	
ปรกติ 	bprohkL gaL dtiL	
ปรมาตมัน	bpaL raH maatF dtaL manM	
ประกาศนียบัตร 	bpraL gaatL saL neeM yaH batL	
ประชาธิปไตย 	bpraL chaaM thipH bpaL dtaiM	
ประชาธิปัตยภิวัฒน์	bpraL chaaM thiH bpatL dtaL yaH phiH watH	
ประดิษ	bpraL ditL saL	
ประทุษกรรม	bpraL thootH saL gamM	
ประธานาธิบดี 	bpraL thaaM naaM thipH baawM deeM	
ประธานาธิปดี	bpraL thaaM naaM thipH bpaL deeM	
ปรัศนี 	bpratL saL neeM	
ปราถนา	bpraatL thaL naaM	
ปรารถนา 	bpraatL thaL naaR	
ปราศ	bpraatL saL	
ปริวรรตกรรม	bpaL riH watH dtaL gamM	
ปริศนา 	bpritL saL naaR	
ปฤษฎางค์	bpritL saL daangM	
ปลาสนาการ	bpaL laatF saL naaM gaanM	
ปักเป้า 	bpakL gaL bpaoF	
ปัจฉิมบท	bpatL chimR maH bohtL	
ปัตคาต 	bpatL dtaL khaatF	
ปัถพี	bpatL thaL pheeM	
land; earth
ปัศตัน 	bpatL saL dtanM	
ปูชนียบุคคล	bpuutL chaH neeM yaH bookL khohnM	
venerable person
โปรเพน	bpro:hM phaehnM	
ผล	phohnR laH	
ผลิต	phaL litL dtaL	
ผลิตภาพ	phlitL dtaL phaapF	
ผัคคุณมาส	phakL khoonM naH maatF	
พจนานุกรม 	phohtH jaL naaM nooH grohmM	
พจมาน	phohtH jaL maanM	
พยช 	phaH yohtH chaH	
พรรณนา 	phanM naH naaM	
พรรดึก 	phanM raH deukL	
พรหม	phrohmM maH	
พระบรมราโชวาท	phraH baL rohmM maH raaM cho:hM waatF	
พระบรมรูป	phraH baL rohmM maH ruupF	
พระบรมวงศ์	phraH baawM rohmM maH wohngM	
พระบรมวงศ์เธอ 	phraH baL rohmM maH wohngM thuuhrM	
พระบรมวงศานุวงศ์ 	phraH baL rohmM maH wohngM saaR nooH wohngM	
พระบาทสมเด็จพระปรเมนทรรามาธิบดีศรีสินทรมหาวชิราลงกรณ พระวชิรเกล้าเจ้าอยู่หัว	phraH baatL sohmR detL phraH bpaL raH maehnM thaH raH raaM maaM thiH baL deeM seeR sinR thaawnM maH haaR waH chiH raaM lohngM grohnM phraH waH chiH raH glaoF jaoF aL yuuF huaaR	
พระพิฆเนศ	phraH phikH khaH naehtF	
พระพุทธรูป	phraH phooH thohtH thaH ruupF	
พระรัตนตรัย 	phraH ratH dtaL naH dtraiM	
พระราชทาน 	phraH raatF chaH thaanM	
พระราชประสงค์ 	phraH raatF chaH bpraL sohngR	
พระราชวงศ์	phraH raatF chaH wohngM	
พระราชสมภพ 	phraH raatF chaH sohmR phohpH	
พระราชเสาวนีย์	phraH raatF chaH saoR waH neeM	
พระราชหัตถเลขา	phraH raatF chaH hatL thaL laehM khaaR	
พระราชอัธยาศัย 	phraH raatF chaH atL thaH yaaM saiR	
พฤศจิก 	phreutH saL jikL	
ราศีพฤศจิก[n, prop.n, formal, loan, S] Thai Zodiac sign for Scorpio, the eighth sign of the zodiac
พฤศจิกายน 	phreutH saL jiL gaaM yohnM	
พฤษภาคม 	phreutH saL phaaM khohmM	
พฤหัสบดี 	phreuH hatL saL baawM deeM	
พฤหัสบดี	phaH reuH hatL saL baawM deeM	
พล	phohnM laH	
พลวัต	phohnM laH watH	
พะยุพยุง	phaH yoopH phaH yoongM	
พัชนี	phatH chaH neeM	
พัชรพร	phatH chaH raH phaawnM	
พัฒนกร	phatH thaH naH gaawnM	
พัฒนา 	phatH thaH naaM	
พัทยา 	phatH thaH yaaM	
พัทลุง 	phatH thaH loongM	
พัลวัน 	phanM laH wanM	
พัศดี 	phatH saL deeM	
พัสดุ 	phatH saL dooL	
พัสถาน	phatH saL thaanR	
พาณิชยกรรม	phaaM nitH chaH yaH gamM	
พาณิชยการ	phaaM nitH chaH yaH gaanM	
พาณิชยศาสตร์	phaaM nitH chaH yaH saatL	
พิทย	phitH thaH yaH	
พิทยา	phitH thaH yaaM	
พิทยาคม	phitH thaH yaaM khohmM	
พิทยาคาร 	phitH thaH yaaM khaanM	
พิพิธภัณฑ์ 	phiH phitH thaH phanM	
พิศวง 	phitH saL wohngR	
พิศวาส	phitH saL waatL	
พิษฐาน	phitH saL thaanR	
พิษณุโลก 	phitH saL nooH lo:hkF	
พิสดาร 	phitH saL daanM	
พิสมัย 	phitH saL maiR	
พุทธมามกะ	phootH thaH maamM maH gaL	
พุทธศตวรรษ	phootH thaH saL dtaL watH	
พุทธศาสนิกชน	phootH thaH saatL saL nikH gaL chohnM	
พุทธานุสติ	phootH thaaM nootH saL dtiL	
เพทนา 	phaehtF thaH naaM	
เพลิงพระราชทาน 	phleerngM phraH raatF chaH thaanM	
แพทยสภา	phaaetF thaH yaH saL phaaM	
Medical Council of Thailand
แพศยา	phaaetF saL yaaR	
ภควัทคีตา 	phohkH khaH watH kheeM dtaaM	
ภมรี 	phohmM maH reeM	
ภรตศาสตร์	phaH rohtH dtaL saatL	
science of dancing and singing
ภรรยา 	phanM raH yaaM	
ภัทรบทมาส	phatH thaH raH bohtL thaH maatF	
ภัสดา 	phatH saL daaM	
ภาคยานุวัติ	phaakF khaH yaaM nooH watH	
ภาชนะ 	phaaM chaH naH	
ภาพ	phaapF phaH	
ภาวการณ์	phaaoM waH gaanM	
ภุมระ	phoomM maH raH	
ภุมวาร 	phoomM maH waanM	
เภสัช	phaehM satL chaH	
โภคทรัพย์	pho:hkF khaH sapH	
โภคภัณฑ์	pho:hkF khaH phanM	
โภชนา 	pho:hM chaH naaM	
มกราคม 	mohkH gaL raaM khohmM	
มกุฏราชกุมาร 	maH gootL raatF chaH gooL maanM	
มงคล	mohngM khohnM laH	
มนุษย	maH nootH saL yaH	
มนุษย	maH nootH saL yaH	
มนุษยชน	maH nootH saL yaH chohnM	
มนุษยนิยม	maH nootH saL yaH niH yohmM	
มรรคนายก	makH khaH naaM yohkH	
มรรคนายก	makH khaH naaM yohkH	
มฤคทายวัน	maH reukH khaH thaaM yaH wanM	
มฤคทายวัน	maH reukH khaH thaaiM yaH wanM	
มฤตยู 	maH reutH dtaL yuuM	
ดาวพระมฤตยู[n] the planet Uranus
มล	mohnM laH	
มลทัศน์	mohnM laH thatH	
มลรัฐ 	mohnM laH ratH	
มหัศจรรย์ 	maH hatL saL janM	
มหาตมะ	maH haatL dtaL maH	
มัคนายก	makH khaH naaM yohkH	
มัคนายก	makH khaH naaM yohkH	
มัทวะ	matH thaH waH	
มัธย	matH thaH yaH	
มัธยม 	matH thaH yohmM	
มัธยม	matH thaH yaH maH	
มัธยะ 	matH thaH yaH	
มัธยัสถ์ 	matH thaH yatH	
มัธยัสถ์	matH thaH yatH	
มัศยา 	matH saL yaaR	
มัสตาด	matH saL dtaatL	
มัสมั่น 	matH saL manL	
แกงมัสมั่น[n] southern Thai style curry with cinnamon; cardomans; peanuts
มัสยา	matH saL yaaM	
มัสยิด	matH saL yitH	
มัสยิส	matH saL yitH	
มัสลิน 	matH saL linM	
มิคสัญญี 	mikH khaH sanR yeeM	
มิสกวัน 	mitH saL gaL wanM	
มุข	mookH khaL	
มุขย	mookH khaL yaH	
มุสลิม 	mootH saL limM	
ไมยราบ 	maiM yaH raapF	
ยม 	yohmM maH	
ยมบาล	yohmM maH baanM	
ยัชโญปวีต	yatH chaH yo:hM bpweetL	
รณรงค์ 	rohnM naH rohngM	
รมณี 	rohmM maH neeM	
รัช 	ratH chaH	
รัชดาภิเษก 	ratH chaH daaM phiH saehkL	
ถนนรัชดาภิเษก[prop.n, geog] [name of a road in Bangkok] Rajadabhisake; Rachadapisek; etc.
รัชทายาท	ratH chaH thaaM yaatF	
รัชน 	ratH chaH naH	
รัชนี 	ratH chaH neeM	
รัฐ	ratH thaL	
รัฐบาล 	ratH thaL baanM	
รัฐประศาสนศาสตร์	ratH thaL bpraL saatL saL naH saatL	
รัตน	ratH dtaL naH	
รัตนตรัย	ratH dtaL naH dtraiM	
รัตนา	ratH dtaL naaM	
รัศมี 	ratH saL meeR	
รัษฎากร	ratH saL daaM gaawnM	
revenue collected by a country or state; national revenue
รัส	ratH saL	
ราช 	raatF chaH	
ราชการ 	raatF chaH gaanM	
ราชกิจจานุเบกษา 	raatF chaH gitL jaaM nooH baehkL saaR	
the Government Gazette; the publication for all official notices
ราชดำเนิน 	raatF chaH damM neernM	
ราชดำริ 	raatF chaH damM riH	
ถนนราชดำริ[prop.n, geog] [name of a road in Bangkok] Rajdumri; Rajadamri; Ratchadamri; etc.
ราชทัณฑ์	raatF chaH thanM	
ราชทินนาม	raatF thinM naH naamM	
ราชเทวี	raatF chaH thaehM weeM	
เขตราชเทวี[prop.n] [administrative district of Bangkok] Ratchathewi
ราชธานี 	raatF chaH thaaM neeM	
ราชนิกุล 	raatF chaH niH goonM	
ราชบัณฑิตยสภา	raatF chaH banM thitH dtaL yaH saL phaaM	
ราชบุรี 	raatF chaH booL reeM	
ราชประสงค์ 	raatF chaH bpraL sohngR	
ราชปรารภ 	raatF chaH bpraaM rohpH	
ถนนราชปรารภ[prop.n] [name of a road in Bangkok] Rajaprarop; Rachaprarop; Rajprarop
ราชพฤกษ์	raatF chaH phreukH	
ราชภักดิ์	raatF chaH phakH	
ราชภัฏ 	raatF chaH phatH	
ราชวงศ์ 	raatF chaH wohngM	
ราชวงศานุวงศ์	raatF chaH wohngM saaR nooH wohngM	
ราชสีมา 	raatF chaH seeR maaM	
Ratchasima
ราพณาสูร 	raapF phaH naaM suunR	
รามเกียรติ์ 	raamM maH giianM	
ราษฎร	raatF saL daawnM	
รูป	ruupF bpaL	
รูปการณ์	ruupF bpaL gaanM	
รูปธรรม 	ruupF bpaL thamM	
ฤคเวท 	reukH khaH waehtF	
ลัคนา	lakH khaH naaM	
ลิขสิทธิ์ 	likH khaL sitL	
โลกุตรธรรม	lo:hM gootL dtaL raH thamM	
วงศาคณาญาติ	wohngM saaR khaH naaM yaatF	
วจีสุจริต	waH jeeM sootL jaL ritH	
วรรณ	wanM naH	
วรรณคดี 	wanM naH khaH deeM	
วรรณศิลป์	wanM naH sinR	
วัจนลีลา	watH jaL naH leeM laaM	
วัชพืช 	watH chaH pheuutF	
วัชราภรณ์	watH chaH raaM phohnM	
วัฏจักร	watH dtaL jakL	
วัฒนธรรม 	watH thaH naH thamM	
วัฒนา 	watH thaH naaM	
วัณโรค	wanM naH ro:hkF	
วัดอรุณราชวราราม	watH aL roonM raatF chaH waH raaM raamM	
วัน	wanM naH	
วัยวุฒิ	waiM yaH wootH	
วัยวุฒิ	waiM yaH wooH thiH	
วัสดุ 	watH saL dooL	
วัสดุอุปกรณ์	watH saL dooL oopL bpaL gaawnM	
วากย	waakF gaL yaH	
วากยะ 	waakF gaL yaH	
วาทกรรม	waatF thaH gamM	
วาทยกร	waatF thaH yaH gaawnM	
วาสนา 	waatF saL naaR	
วิกตรรถกริยา	wikH gaL dtatL griL yaaM	
วิกฤต	wiH gritL dtaL	
วิกาลโภชน์ 	wiH gaanM laH pho:htF	
วิทยฐานะ	witH thaH yaH thaaR naH	
วิทยา 	witH thaH yaaM	
วิทยาคม	witH thaH yaaM khohmM	
วิทยาทาน	witH thaH yaaM thaanM	
วิทยาราม	witH thaH yaaM raamM	
วิทยาลัย 	witH thaH yaaM laiM	
วิทยุ 	witH thaH yooH	
วิปโยค	wipH bpaL yo:hkF	
วิปลาส 	wipH bpaL laatF	
วิภวตัณหา	wipH phaH waH dtanM haaR	
วิยุตคณิต	wiH yootH dtaL khaH nitH	
วิวัฒนาการ 	wiH watH thaH naaM gaanM	
วิศวกร 	witH saL waH gaawnM	
วิศวกรรม 	witH saL waH gamM	
วิษณุ 	witH saL nooH	
วิสกี้	witH saL geeF	
วิสัชนา 	wiH satL chaH naaM	
วิสุงคามสีมา	wiH soongR khaamM maH seeR maaM	
วีรคติ	weeM raH khaH dtiL	
เวช	waehtF chaH	
เวชศาสตร์ 	waehtF chaH saatL	
เวทนา 	waehtF thaH naaM	
เวศยา 	waehtF saL yaaR	
ไวยาวัจกร 	waiM yaaM watH jaL gaawnM	
ศรีธรรมราช 	seeR thamM maH raatF	
ศรีวิชัย	seeR wiH chaiM yaH	
ศักดา 	sakL gaL daaM	
ศักย 	sakL gaL yaH	
ศักราช 	sakL gaL raatL	
ศัพทมูลวิทยา	sapL thaH muunM laH witH yaaM	
ศัลย 	sanR laH yaH	
ศากย 	saakL gaL yaH	
ศาสดา 	saatL saL daaM	
ศาสนา 	saatL saL naaR	
ศาสนาจารย์	saatL saL naaM jaanM	
ศาสนิกชน 	saaR saL nikH gaL chohnM	
ศาสนิกสนทนา	saatL saL niH gaL sohnR thaH naaM	
ศาสนูปถัมภก 	saatL saL nuuM bpaL thamR phohkH	
ศิลป	sinR laH bpaL	
ศิลปะ	sinR laH bpaL	
ศิษยานุศิษย์	sitL saL yaaM nooH sitL	
ศีล	seenR laH	
ศุภ	soopL phaH	
ศุภชลาศัย 	soopL phaH chaH laaM saiR	
The Subhachalasai National Stadium
ศุภนิมิต	soopL phaH niH mitH	
good omen; good dream; auspicious time; propitious sign; auspice; dream foretelling fortune, good luck
ศุภผล	soopL phaH phohnR	
ศุภมาส	soopL phaH maatF	
ศุภรัตน์	soopL phaH ratH	
ศุภวิทย์	soopL phaH witH	
ศุภอักษร	soopL phaH akL saawnR	
ศุลกากร 	soonR laH gaaM gaawnM	
เศวตฉัตร	saL waehtL dtaL chatL	
สกปรก 	sohkL gaL bprohkL	
สเด็จพระนางเจ้าสุทิดา พัชรสุธาพิมลลักษณ พระบรมราชินี	saL detL phraH naangM jaoF sooL thiH daaM phatH chaH raH sooL thaaM phiH mohnM lakH saL naH phraH baL rohmM raaM chiH neeM	
สถาน	saL thaanR naH	
สถาปัตยกรรม 	saL thaaR bpatL dtaL yaH gamM	
สนามราชมังคลากีฬาสถาน	saL naamM raatF chaH mangM khaH laaM geeM laaM saL thaanR	
สเป็กโทรสโขป	saL bpekL thro:hM saL kho:hpL	
สม	sohmR maH	
สมนา	sohmR maH naaM	
สมนาคุณ	sohmR maH naaM khoonM	
สมรรถ 	saL matH thaL	
สมรรถนะ	saL matH thaL naH	
สมานฉันท์ 	saL maanM naH chanR	
สยาม	saL yaamM maH	
สรรพ	sapL phaH	
สรรพนาม 	sapL phaH naamM	
คำสรรพนาม[n, pl, formal] [grammar] pronoun; pronouns
สฬายตนะ	saL laaiM yaH dtaL naH	
สักหลาด 	sakL gaL laatL	
สังคายนา	sangR khaaiM yaH naaM	
สังหาริมทรัพย์ 	sangR haaR rimM maH sapH	
สัจ	satL jaL	
สัจนิยม	satL jaL niH yohmM	
สัจพจน์ 	satL jaL phohtH	
สัจวจน 	satL jaL waH jaL naH	
สัจสัมมตา 	satL jaL samR maH dtaaM	
สัญชาตญาณ 	sanR chaatF dtaL yaanM	
สัตภัณฑ์	satL dtaL phanM	
สัตยาบัน 	satL dtaL yaaM banM	
สัตว 	satL dtaL waH	
สัตวบาล	satL dtaL waH baanM	
สัตวาร 	satL dtaL waanM	
สัตหีบ	satL dtaL heepL	
สัทวิทยา	satL thaH witH yaaM	
สัทศาสตร์	satL thaH saatL	
สัทอักษร	satL thaH akL saawnR	
สัปคับ	sapL bpaL khapH	
สัปทน 	sapL bpaL thohnM	
สัปหงก	sapL bpaL ngohkL	
สัปเหร่อ 	sapL bpaL ruuhrL	
สัพยอก 	sapL phaH yaawkF	
to speak jestingly; to jest; to joke; to tease; to banter; to make fun; to fool
สัมปรายภพ	samR bpaL raaiM yaH phohpH	
สาธิตยัง	saaR thitH dtaL yangM	
สาม	saamR maH	
สารบรรณ 	saanR raH banM	
สารีริกธาตุ	saaR reeM rikH gaL thaatF	
relics of the Buddha
สาสนา 	saatL saL naaR	
สิริวัฒนาพรรณวดี 	siL riH watH naaM phanM naH waH deeM	
สุข	sookL khaL	
สุคติ 	sookL khaH dtiL	
สุจริต	sootL jaL ritL	
สุริยุปราคา	sooL riH yoopH bpaL raaM khaaM	
สุวรรณภูมิ 	sooL wanM naH phuumM	
เสถียร	saL thiianR raH	
เสลภูมิ	saehnR laH phuumM	
โสมนัส 	so:hmR maH natH	
ไสย	saiR yaH	
หม่อมราชวงศ์ 	maawmL raatF chaH wohngM	
หายนภัย	haaiR yaH naH phaiM	
หิน	hinR naH	
หินยาน 	hinR naH yaanM	
หิมพานต์ 	himR maH phaanM	
หิมาลัย	hiL maaM laiM yaH	
หีนยาน	heenR naH yaanM naH	
อตรรกยะ	aL dtakL gaL yaH	
อธิกสุรทิน	aL thikH gaL sooL raH thinM	
อธิบดี 	aL thipH baawM deeM	
อธิปไตย	aL thipH bpaL dtaiM	
อนาคต	aL naaM khohtH dtaL	
the future
อนารยะ	aL naaM raH yaH	
อนิจกรรม	aL nitH jaL gamM	
อนุสติ	aL nootH saL dtiL	
อบายมุข	aL baaiM yaH mookH	
อปรกติ	aL bprohkL gaL dtiL	
อพยพ 	ohpL phaH yohpH	
อภัยโทษ	aL phaiM yaH tho:htF	
อภิชนาธิปไตย	aL phiH chaH naaM thipH bpaL dtaiM	
อภิมหา	aL phiH maH haaR	
อมรรัตน์	aL maawnM raH ratH	
อมาตยาธิปไตย	aL maatL dtaL yaaM thipH bpaL dtaiM	
อมาตยาธิปไตย	aL maaM dtaL yaaM thipH bpaL dtaiM	
อยุธยา 	aL yootH thaH yaaM	
อรรถคดี	atL thaL khaH deeM	
อรรถรส	atL thaL rohtH	
อรรถสิทธิ์	atL thaL sitL	
อรรธจันทร์	atL thaH janM	
อรรธสระ	atL thaH saL raH	
อรัญวาสี	aL ranM yaH waaM seeR	
อลวน 	ohnM laH wohnM	
อลเวง 	ohnM laH waehngM	
อลหม่าน 	ohnM laH maanL	
อวดอุตริมนุสธรรม	uaatL ootL dtaL riH maH nootH saL thamM	
อวัยวะ 	aL waiM yaH waH	
อวิโรธนะ	aL wiH ro:htF thaH naH	
อสัญ	aL sanR yaH	
อัคนี 	akL khaH neeM	
อัครมหาเสนาบดี	akL khaH raH maH haaR saehR naaM baL deeM	
อัครมเหสี	akL raH maH haehR seeR	
อัญ	anM yaH	
อัญประกาศ	anM yaH bpraL gaatL	
อัฐ	atL thaL	
อัฒจันทร์	atL thaH janM thaH	
อัฒสระ	atL thaH saL raH	
อัต 	atL dtaL	
อัตคัด 	atL dtaL khatH	
อัตชีวประวัติ	atL dtaL cheeM waH bpraL watH	
อัตนัย 	atL dtaL naiM	
อัตโนมัติ 	atL dtaL no:hM matH	
อัตภาพ	atL dtaL phaapF	
อัตวินิบาตกรรม	atL dtaL wiH niH baatL dtaL gamM	
อัตวิสัย	atL dtaL wiH saiR	
อัธยาศัย	atL thaH yaaM saiR	
อัมพร	amM maH phaawnM	
อัมพฤกษ์	amM maH phreukH	
อัมพาต 	amM maH phaatF	
อัยการ 	aiM yaH gaanM	
อัลกุรอาน	anM laH gooL raH aanM	
อัศจรรย์ 	atL saL janM	
อัศเจรีย์	atL saL jaehM reeM	
อัศวยุชมาส	atL saL waH yootH chaH maatF	
อัศวา 	atL saL waaM	
อัศวานึก 	atL saL waaM neukH	
อัศวิน	atL saL winM	
อัษฎา 	atL saL daaM	
อัษฏางค์	atL saL dtaangM	
อัษรา	atL saL raaM	
อัสดง	atL saL dohngM	
to set (with respect to the sun); go down
อัสดงคต	atL saL dohngM khohtH	
อากาศ	aaM gaatL saL	
อาชญากร 	aatL chaH yaaM gaawnM	
อาชญากรรม 	aatL chaH yaaM gamM	
อาชญาสิทธ์	aatL chaH yaaM sitL	
อาชวะ 	aatL chaH waH	
อาชีวปฏิญาณ	aaM cheeM waH bpaL dtiL yaanM	
อาตม 	aatL dtaL maH	
อาราธนา	aaM raatF thaH naaM	
อาเศียรวาท	aaM siianR raH waatF	
อาษาฒมาส	aaM saatL thaH maatF	
อาสนะ	aatL saL naH	
อาสาฬหปุรณ	aaM saanR laH haL bpooL rohnM	
อำมาตยาธิปไตย	amM maaM dtaL yaaM thipH bpaL dtaiM	
อิสร	itL saL raL	
อิสระ 	itL saL raL	
อิสราเอล 	itL saL raaM aehnM	
อิสลาม 	itL saL laamM	
อึกทึก 	eukL gaL theukH	
อุตพิด 	ootL dtaL phitH	
อุตรดิตถ์ 	ootL dtaL raH ditL	
อุตรนิกาย 	ootL dtaL raH niH gaaiM	
อุตรนิกาย	ootL dtaL raH niH gaaM yaH	
อุตลุด	ootL dtaL lootL	
อุทกภัย	ooL thohkH gaL phaiM	
อุทกศาสตร์	ooL thohkH gaL saatL	
อุทยาน 	ootL thaH yaanM	
อุบลรัตนราชกัญญา 	ooL bohnM ratH naH raatF chaH ganM yaaM	
อุปการะ	oopL bpaL gaaM raH	
อุปการิณี	oopL bpaL gaaM riH neeM	
อุปการี	oopL bpaL gaaM reeM	
อุปถัมภ์ 	oopL bpaL thamR	
อุปทาน 	oopL bpaL thaanM	
อุปนิสัย 	oopL bpaL niH saiR	
อุปนิเสธ	oopL bpaL niH saehtL	
อุปโภค 	oopL bpaL pho:hkF	
อุปมา 	oopL bpaL maaM	
อุปมานิทัศน์	oopL bpaL maaM niH thatH	
อุปไมย 	oopL bpaL maiM	
อุปราช	oopL bpaL raatF	
a second king; a local king
อุปสงค์	oopL bpaL sohngR	
อุปสรรค 	oopL bpaL sakL	
เอก	aehkL gaL	
เอกพงษ์	aehkL gaL phohngM	
เอกมัย 	aehkL gaL maiM	
เอกรรถประโยค	aehM gatL thaL bpraL yo:hkF	
เอกสิทธิ์	aehkL gaL sitL	
เอกใหม่	aehkL gaL maiL	
เอกาธิปไตย	aehM gaaM thipH bpaL dtaiM	
เอหิภิกขุอุปสัมปทา	aehM hiL phikH khooL oopL bpaL samR bpaL thaaM	
โอช	o:htL chaH	
ไอยเรศ 	aiM yaH raehtF	
